#################################################
#         #     #       #########              ##
### # ### ##### # #####           ########## # ##
#   #   #     # # #     # ##### # #        # # ##
# ####### ### # ### ##### #   # # # ###### # # ##
#       #   # #     #   # # ### # #      # # # ##
# ##### ##### ##### # #  ## # # # ######## # # ##
# #   #     #       # B#   # # # #   #         ##
# ### ##### ### ### ### # ### # ### ## ######## #
#   # #     #     #     #     #     ##    #     #
##### # ### ##### ##### ##### ######### ####### #
#   #   # #     # #   #     #   ##      #       #
# # ### # ##### # # # ##### ### ## ###### ##### #
# #   # #     # # # # #     #             #   # #
# ### # ### # # # # # ####### ########### ## # ##
#     #   # # #   # #       #           #    #  #
##### ### # ##### ### ##### ######### ### #######
#         #       #       #         #           #
###### ##########################################
# A                                             #
#################################################
