####################################
#   ###         #########       # ##
# # ##### ##### ##       ##### # # #
# #     #     # ## #######     # # #
### ### ## ## # ## ##### ####### # #
#     #     # # ##       ##   ## # #
### # ####### # ####### ######### ##
# # #     ##  #     ###          # #
# # ##### ## ## ### ##### ###### ###
# #   #   ## ## ###  #    ##      ##
# ### ##### ## ##### ########### ###
#   #        # #     ##   ##     # #
##### ### # ## ##### ## ### ###### #
#       # #  #     #        #     ##
# ####### #### ###### #####  #### ##
#           ##        ##     ##   ##
######  #################  #########
A                     ##          B#
####################################
