#################################################
#         #     #       #########       B       #
### # ### ##### # #####           ########## # ##
#   #   #     # # #     # ##### # #        # # ##
# ####### ### # ### ##### #   # # # ###### # # ##
#       #   # #     #   # # ### # #      # # # ##
# ##### ##### ##### # #  ## # # # ######## # # ##
# #   #     #       #  #   # # # #   #         ##
# ### ##### ### ### ### # ### # ### ## ######## #
#   # #     #     #     #     #     ##    #     #
##### # ### ##### ##### ##### ######### ####### #
#   #   # #     # #   #     #   ##      #       #
# # ### # ##### # # # ##### ### ## ###### ##### #
# #   # #     # # # # #     #             #   # #
# ### # ### # # # # # ####### ########### ## # ##
#     #   # # #   # #       #           #    #  #
#         #     #       #########              ##
### # ### ##### # #####           ########## # ##
#   #   #     # # #     # ##### # #        # # ##
# ####### ### # ### ##### #   # # # ###### # # ##
#       #   # #     #   # # ### # #      # # # ##
# ##### ##### ##### # #  ## # # # ######## # # ##
# #   #     #       #  #   # # # #   #         ##
# ### ##### ### ### ### # ### # ### ## ######## #
#   # #     #     #     #     #     ##    #     #
##### # ### ##### ##### ##### ######### ####### #
#   #   # #     # #   #     #   ##      #       #
# # ### # ##### # # # ##### ### ## ###### ##### #
# #   # #     # # # # #     #             #   # #
# ### # ### # # # # # ####### ########### ## # ##
#  A   #   # # #   # #       #           #    # #
#################################################